10 15
###############
#             #
# #### # ###  #
# #### # ###  #
# ###### # #  #
#P####   # #  #
# ######## ## #
# ###      ## #
#     ####  #F#
###############
